11111111
100C00E1
1P0CC001
100C0001
11111111
