111111111111111111111111111111111111
1P0000000000000000000000000000000001
100000000000111111111E00000000000001
100000100000000000CCC1111110000001E1
111111111111111111111111111111111111
