11111111
1P00C001
1C01E001
11111111
